XXXXXXXXXXXXXXX
XXXXXX   XX   X
X   X O       X
X             X
X   XX   XX   X
XXXXXXXXXXXXXXX